95553D5553
C793C5553A
BFA87FFFAA
AFEC157FC2
AFFFAFFFBA
C13FAFD52A
96AFAFFFAA
A96905556A
AE96C39396
C5457C6C47

1, 1
0, 0
WN
