B93D51393B
AEC396C6C2
AF96AFFF96
AFC5457FAB
AFFFBFFFC2
A93FAFD516
86AFAFFFAB
C3A94393AA
96AC3AAC6A
C7C56C4556

1, 1
3, 2

N E S E S
