D555555513
979395556A
AFAC6FFF96
AFC5157FAB
AFFFAFFFAA
A97FAFD52A
AC3FAFFFC2
C543853956
957AC7AC53
C554556D56

1, 1
5, 5


