9391793913
AC6C56EEAA
AF957FFFAA
AFC5157FAA
AFFFAFFFAA
C53FAFD52A
97AFAFFFAA
85694553AA
A93AB956AA
C6C6C4556E

6, 1
0, 0
NWSWWNWSWNW
